XXXXXXXXXXXXXXXXXXXXXXXXXXXXXXXX
X   XXXXXX  XX   XXXXXXXXXX    X
X   XXXXXXXXXX    XXXXXXXXXX   X
X    XXXXXXXXX    XXXXXXXXXX   X
X     XXXXXXXX    XXXXXXXXXX   X
X      XX XXXX    XXXXXXXXXX XXX
X   XXX    XXX     XXXXXXXXX XXX
X  XXXXX    XX     XXXXX XX   XX
X  XXXXX      VVV  XXX 2    1  X
X   XXX   J   VVV XXX     0    X
X   T         VVV XXX   4  XXXXX
X      X    B    XXXX   3  XXXXX
X D     B  XXX B           XXXXX
X          XXX     A     XXX   X
X     X  XXXX            XXX   X
X  M    XXXXX B          XXX   X
X      XXXXX      VVV        XXX
X    X XXX   B  X VVV   XXXXXXXX
X     X    FF     VVV  XXXXXXXXX
XX  X      FFF        XXXXXXXXXX
X X  X             XXXXXXXXXXXXX
XXXXXXXXXXXXXXXXXXXXXXXXXXXXXXXX
