XXXXXXXXXXXXXXXXXXXXXXXXXXXXXXXX
X   XXXXXX  XX   XXXXXXXXXX    X
X   XXXXXXXXXX    XXXXXXXXXX   X
X    XXXXXXXXX    XXXXXXXXXX   X
X     XXXXXXXX    XXXXXXXXXX   X
X      XX XXXX    XXXXXXXXXX XXX
X   XXX    XXX     XXXXXXXXX XXX
X  XXXXX    XX     XXXXX XX   XX
X  XXXXX      VVV  XXX         X
X   XXX       VVV XXX          X
X             VVV XXX      XXXXX
X      X    B    XXXX      XXXXX
X       B  XXX B           XXXXX
X          XXX     A     XXX   X
X     X  XXXX            XXX   X
X       XXXXX B          XCX   X
X      XXXXX      VVV        XXX
X    X XXX   B  X VVV   XXXXXXXX
X     X    FF     VVV  XXXXXXXXX
XX  X      FFF        XXXXXXXXXX
X X  X             XXXXXXXXXXXXX
XXXXXXXXXXXXXXXXXXXXXXXXXXXXXXXX
