XXXXXXXXXXXXXXXXXXXXXXXXXXXXXXXX
XXXXXXXXXXXXXXXXXXXXXXXXX     XX
XXXXXXXXXXXXXXXXXXXXXXXX   S  XX
XXXXXXXXXXXXXXXXXXXXXXXX M    XX
XXXXXXXXXXXXXXXXXXXXXXXX XXXX XX
XXXXXX  XXXXXXXXX  XXXXX      XX
XXXXX 10 XXXXXXX    XXXX  XX   X
XXXXX  3 XXXXXXX  Z XXXX  XX   X
XXXX 2 4              D   J   XX
XXXX   H  XXXXX   G  XXXXX  XXXX
XXXX      XXXXX XXXX XXXXXXXXXXX
XXXX XXXX XXXXX      XXXXXXXXXXX
XXXX      XXXXX  XX  XXX      XX
XXXX  XX  XXXXX  XX  XXXXXXXXXXX
XXXX  XX        L    XXXXXXXXXXX
XXXX      XXXXXXX  XXXXXXXXXXXXX
XXXXXX  XXXXXXXXXXXXXXXXXXXXXXXX
XXXXXXXXXXXXXXXXXXXXXXXXXXXXXXXX
XXXXXXXXXXXXXXXXXXXXXXXXXXXXXXXX
XXXXXXXXXXXXXXXXXXXXXXXXXXXXXXXX
XXXXXXXXXXXXXXXXXXXXXXXXXXXXXXXX
XXXXXXXXXXXXXXXXXXXXXXXXXXXXXXXX
