XXXXXXXXXXXXXXXXXXXXXXXXXXXXXXXX
XXXXXXXXXXXXXXXXXXXXXXXXX     XX
XXXXXXXXXXXXXXXXXXXXXXXX H H  XX
XXXXXXXXXXXXXXXXXXXXXXXX      XX
XXXXXXXXXXXXXXXXXXXXXXXX XXXX XX
XXXXXX  XXXXXXXXX  XXXXX      XX
XXXXX    XXXXXXX    XXXX  XX   X
XXXXX    XXXXXXX    XXXX  XX   X
XXXX      PPPPP   H  PPP      XX
XXXX   H  XXXXX      XXXXX  XXXX
XXXX      XXXXX XXXX XXXXXXXXXXX
XXXX XXXX XXXXX      XXXXXXXXXXX
XXXX      XXXXX  XX  XXX      XX
XXXX HXX  XXXXX  XX  XXXXXXXXXXX
XXXX  XX  PPPPP H    XXXXXXXXXXX
XXXX      XXXXXXX  XXXXXXXXXXXXX
XXXXXX  XXXXXXXXXXXXXXXXXXXXXXXX
XXXXXXXXXXXXXXXXXXXXXXXXXXXXXXXX
XXXXXXXXXXXXXXXXXXXXXXXXXXXXXXXX
XXXXXXXXXXXXXXXXXXXXXXXXXXXXXXXX
XXXXXXXXXXXXXXXXXXXXXXXXXXXXXXXX
XXXXXXXXXXXXXXXXXXXXXXXXXXXXXXXX
