XXXXXXXXXXXXXXXXXXXXXXXXXXXXXXXX
XLLLLLLLLLLLLLLLLLLLLLLXX     XX
XLLLLLLLLLLLLLLLLLLLLLLX H H  XX
XLLLLLXXLLLLLLLLLXXLLLLX      XX
XLLLLXXXXLLLLLLLXXXXLLLX DDDD XX
XLLLLX  XLLLLLLLX  XLLLX      XX
XLLLX    XLLLLLX    XLLX  DD   X  
XLLLX    XLLLLLX    XLLX  DD   X
XLLX      PPPPP   H  PPP      XX
XLLX   H  XLLLX      XLLXX  XXXX
XLLX      XLLLX DDDD XLXXXXXXXXX
XLLX DDDD XLLLX      XLLXXXXXXLX
XLLX      XLLLX  DD  XLL      LX
XLLX HDD  XLLLX  DD  XLLLLLLLLLX
XLLX  DD  PPPPP H    XLLLLLLLLLX
XLLX      XLLLXXX  XXXLLLLLLLLLX
XLLXXX  XXXLLLXXXXXXXXLLLLLLLLLX
XLLLXXXXXXXXLLLLXXXXXXLLLLLLLLLX
XLLLXXXXXXLLLLLXXXXXXLLLLLLLLLLX
XLLLXXXXXXLLLLLLLLLLLLLLLLLLLLLX
XLLLLLLLLLLLLLLLLLLLLLLLLLLLLLLX
XXXXXXXXXXXXXXXXXXXXXXXXXXXXXXXX