XXXXXXXXXXXXXXXXXXXXXXXXXXXXXXXXXXXXXXXX
X                                      X
X       XXXXX              XXXXX       X
X       XXXXX      e       XXXXX       X
X       XXXXX         h    XXXXX       X
X                                      X
X     h     XXXXXXXXX                  X
X           XXXXXXXXX          P       X
X    e      XXXXXXXXX                  X
X       e                  h    l      X
X                                      X
XXXXXXXXXX XXXXXXXXXXXXXXXXXXXX XXXXXXXX
XB l                                   X
X                                      X
X  l                  P     h    h     X
X         FF                           X
X         FF                           X
X                     e        H 1 2 3 X
X                                      X
X                     e        4 5 6 7 X
XXXXXXXXXXXXXXXXXXXXXXXXXXXXXXXXXXXXXXXX