XXXXXXXXXXXXXXXXXXXXXXXXXXXXXXXX
X FMMMMMMMMB   FFFF   FF   FFFFX
XFFMMMMMMM  FF    F F    CCC FFX
X   MMMMM  VVV LLFB FFF  CCC FFX
X     MMF FVVVFLL      F CCC FFX
X    M    FVVV  FF  A       FFFX
XF FMM        FFBFFFFF     FFFFX
XL FMFF      FFFFFF FF    FFFF X
XLLFFFFF   FFFFVVVFF F F  FFF MX
XFLFFFF   F  FFVVV FFF FF FFF MX
X LFFFF   B MM VVVFFFF  FFFFF MX
X LFFFLL F FMMF F  F   FFIFFF FX
XLLFF LL    MMMM F  VVVFFFFFFF X
XL  SF FFFF MMMMBF FVVVF  F    X
XL   F FFFLL F  FF FVVVF    F  X
X      FFFLL F     FFFFIF    F X
XLLLPLLLLLLL       FBFFFFF     X
X          LL FFFFFFFFFFLLFF FFX
X        F  FP FFFFFIFFFLL FFFFX
X FF     BFFFLFFFBFFFFFF FFFF  X
XFFF       FLLFFFFFFFFFFF      X
XXXXXXXXXXXXXXXXXXXXXXXXXXXXXXXX