XXXXXXXXXXXXXXXXXXXXXXXXXXXXXXXXXXXXXXXX
X H 1 2 3 4 5 6 7    l    a         h  X
X                    l    a         h  X
X      XXAXXX      XXSXX      XXXXXX   X
X      XXXXXX h  h XXXXX      XXXXXX   X
X      XXXXXX      XXXXX      XXXXXX   X
X      XXXXXX   a  XXXXX      XXXXXX   X
XeeeeeeXXXXXX      XXXXX      XXXXXX   X
X      XXXXXX      P   P      XXXXXX   X
X m  m XXXXXX      XXXXX      XXXXXX   X
X      XXXXXX      XXXXX      XXXXXX   X
X      XXXXXX      XXXXX e  e XXXXXX   X
X      XXXXXX      XXXXX      XXXXXX   X
X      C      l  l XXXXX      XXXXXX   X
X                  XXXXX   m           X
X      XXXXXX   e  XXXXX               X
X      XXXXXX      XXXXX   m  XXXXXX   X
X      XXXXXX      XXXXX      XXXXXX   X
X                         e e          X
X   l     l                            X
XXXXXXXXXXXXXXXXXXXXXXXXXXXXXXXXXXXXXXXX