XXXXXXXXXXXXXXXXXXXXXXXXXXXXXXXXXXXXXXXX
XXXXXXXXXXX    a   a   a XXXXXXXXXXXXXXX
XXXXXXXXXX                 XXXXXXXXXXXXX
XXXXXXXXXXX    l   l   l XXXXXXXXXXXXXXX
XXXXXXXXXXXX     e    e XXXXXXXXXXXXXXXX
XXXXXXX XXXXXXXX XXXXXXXX XXXXXXXXXXXXXX
XXXXXX 1 XXXXXXX XXXXXXX   XXXXXXXXXXXXX
XXXXX  2  XXXXXX XXXXXX   m XXXXXXXXXXXX
XXXX   3   XXXXX XXXXX  a    XXXXXXXXXXX
XXXX   4  H    h     h    m  XXXXXXXXXXX
XXXX   5   XXXXXXX XXX  a    XXXXXXXXXXX
XXXXX  6  XXXXXXXX XXXX   m XXXXXXXXXXXX
XXXXXX 7 XXXXXXXXX XXXXX   XXXXXXXXXXXXX
XXXXXXX XXXXXXXXXX XXXXXX XXXXXXXXXXXXXX
XXXXXXXXXXXXXXXXXX XXXXXXXXXXXXXXXXXXXXX
XXXXXXXXXXXXh          hXXXXXXXXXXXXXXXX
XXXXXXXXXXX    e  e  e   XXXXXXXXXXXXXXX
XXXXXXXXXX       XXXX      XXXXXXXXXXXXX
XXXXXXXXXXX    l hh l    XXXXXXXXXXXXXXX
XXXXXXXXXXXX           BXXXXXXXXXXXXXXXX
XXXXXXXXXXXXXXXXXXXXXXXXXXXXXXXXXXXXXXXX