XXXXXXXXXXXXXXXXXXXXXXXXXXXXXXXXXXXXXXXX
X                      OOOOOO         CX
X                                      X
X  l    XXXXX      l          XXXXX    X
X       XXXXX                 XXXXX    X
X  l    XXXXX      l          XXXXX    X
X                                      X
X                            a    a    X
X       e   e   e   e  XXXXXXXXXXXXXXXXX
X                                      X
X           XXXXX     XX               X
X       h   XXXXXl    XX   a   a    a  X
X           XXXXX                      X
X        h            m     FFF        X
X                           FFF  e l l X
X     h          m    h h h h          X
X   XXXXX                              X
X   XXXXX  FFFFFFFF   e        H 1 2 3 X
X   XXSXX  FFFFFFFF      e             X
X          FFFFFFFF   e        4 5 6 7 X
XXXXXXXXXXXXXXXXXXXXXXXXXXXXXXXXXXXXXXXX