XXXXXXXXXXXXXXXXXXXXXXXXXXXXXXXXXXXXXXXX
X                    X   XXXXX  C XXXXXX
X   XXXXX       NNNNNX   XXXXX    XXXXXX
X   XXXXX   l   NNNNNe  lXXSXX  l XXOXXX
X   XXAXX       NNNNNX                 X
X           l        X    h    h    h  X
X                    Xm                X
X      e    e    e   X         a   m  mX
X                    Xm    aXXXXXXXXXXXX
X         h    h     X      X          X
X   h                Xm    aX  H 1 2 3 X
X       F   l l  l l X      X          X
X      F  NNN        X   C  X  4 5 6 7 X
XXXXXXXXXXX XXXXXXXXXXXXXXXXX          X
X                 X             l   l  X
X    F      h  NNNNNNNN    e           X
X  XXX         NNNNNNNN         XXXXXX X
X  XXX  F   h     X        e    XXXXXX X
X  XXX            X             XXXXXX X
X           h     X        e           X
XXXXXXXXXXXXXXXXXXXXXXXXXXXXXXXXXXXXXXXX