XXXXXXXXXXXXXXXXXXXXXXXXXXXXXXXXXXXXXXXX
X          XC  a  l      e             X
X m      m XC  a  l       e            X
X          XXXXXXXXXXXXXXXXXXXX        X
X          l             h    XXXXXXX  X
X          l              h            X
X  e  e  e XXXXXXXXXXXXXXl             X
X          X            X              X
X          X    a a     X  l e l e l h X
X          X   m B m    X              X
X   h  h   X    a a     XXX            X
X          X              X            X
X  l    l  X   l    l   l X            X
X    ee    XXXX  XXX  XX  XXXXXX   XXXXX
X          Xa                 X        X
X l  l  l  X    e e e e e e e X  h  h  X
X          Xa                 X        X
X          XXXXX XX XX XX XXXXX  l  l  X
X H 1 2 3  X           h               X
X  4 5 6 7 X           h               X
XXXXXXXXXXXXXXXXXXXXXXXXXXXXXXXXXXXXXXXX