XXXXXXXXXXXXXXXXXXXXXXXXXXXXXXXX
X   X  XXXX                  F X
X   X  XXXX       XXX          X
X   X  XXXXXXXX            XX  X
X   X              III         X
X   XXX     F      III   XXXWXXX
X                              X
X   FF      F    XXXWXXXX    XXX
XXX  F                         X
X           F      F XXXXXXXAAAX
X           XXX      XXXXXXXAAAX
X   X                          X
XXX X     XX  XXXXXXXXX      X X
X                       XXX  X X
X FF      XXXXXX             XXX
XXXXXXX   XXXXXX   XXX         X
XXXXXXX   XXXXXX       XXX XXXXX
XXXXXXX   X                    X
XXXXXXX   XXXXXXXX        XXXXXX
XXXXXXX              XXX       X
XXXXXXX     XXXX     XXXXXXXX  X
XXXXXXXXXXXXXXXXXXXXXXXXXXXXXXXX