XXXXXXXXXXXXXXXXXXXXXXXXXXXXXXXX
X FXXXXXXXXB   FFFF   FF   FFFFX
XFFXXXXXXX  FF    F F    XXX FFX
X   XXXXX  XXX XXFB FFF  XXX*FFX
X     XXF FXXXFXX      F XCX FFX
X    X    FXVX  FF/ A     W FFFX
XF FXX        FFBFFFFF   K FFFFX
XX FXFF      FFFFFF FF  E FFFF X
XXXFFFFF   FFFFXXXFF F F  FFF XX
XFXFFFF   F  FFXXX FFF FF FFF XX
X XFFFF   B XX XVXFFFF  FFFFF XX
X XFFFXX F FXXF F  F   FFIFFF FX
XXXFF XX    XXXX F  XXXFFFFFFF X
XX   F FFFF XXXXBF FXXXF  F    X
XX   F FFFXX F  FF FXVXF    F  X
X   2  FFFXX F     FFFFIF    F X
XXXX XXXXXXX       FBFFFFF     X
X  1   3   XX FFFFFFFFFFXXFF FFX
X    0   F  F  FFFFFIFFFXX FFFFX
X FF     BFFFXFFFBFFFFFF FFFF  X
XFFF   4   FXXFFFFFFFFFFF      X
XXXXXXXXXXXXXXXXXXXXXXXXXXXXXXXX
