XXXXXXXXXXXXXXXXXXXXXXXXXXXXXXXX
X FXXXXXXXXB   FFFF   FF   FFFFX
XFFXXXXXXX  FF    F F    XXX FFX
X   XXXMX  XXX XXFB FFF  XXX*FFX
X     XXF FXXXFXX      F XCX FFX
X    X    FXVX  FF/ A     W FFFX
XF FXXD       FFBFFFFF   K FFFFX
XX FXFF  J   FFFFFF FF  E FZFF X
XXXFFFFF   FFFFXXXFF F F  FFF XX
XFXFFFF   F  FFXXX FFF FF JFF XX
X XFFLF   B XX XVXFFFF  FFFFF XX
X XFFFXX F FXXF F  F   FFIFFF FX
XXXFF XX    XXXX F  XXXFFFFFFF X
XX   F FFFF XXXXBF FXXXF  F    X
XX   F FFFXX F  FF FXVXF    F  X
X   2  FFFXX F     FFFFIF    F X
XXXX XXXXXXX       FBFFFFF     X
X  1   3   XX FFFFFFFFFFXXFF FFX
X    0   F  F  FFFFFIFFFXX FFFFX
X FF     BFFFXFFFBFFFFFF FFFF  X
XFFF   4   FXXFFFFFFFFFFF      X
XXXXXXXXXXXXXXXXXXXXXXXXXXXXXXXX
