XXXXXXXXXXXXXXXXXXXXXXXXXXXXXXXX
X FXXXXXXXXB   FFFF   FF   FFFFX
XFFXXXXXXX  FF    F F    XXX FFX
X   XXXXX  XXX XXFB FFF  XXX FFX
X     XXF FXXXFXX      F XCX FFX
X    X    FXVX  FF  A       FFFX
XF FXX        FFBFFFFF     FFFFX
XX FXFF      FFFFFF FF    FFFF X
XXXFFFFF   FFFFXXXFF F F  FFF XX
XFXFFFF   F  FFXXX FFF FF FFF XX
X XFFFF   B XX XVXFFFF  FFFFF XX
X XFFFXX F FXXF F  F   FFIFFF FX
XXXFF XX    XXXX F  XXXFFFFFFF X
XX   F FFFF XXXXBF FXXXF  F    X
XX   F FFFXX F  FF FXVXF    F  X
X      FFFXX F     FFFFIF    F X
XXXXPXXXXXXX       FBFFFFF     X
X          XX FFFFFFFFFFXXFF FFX
X        F  FP FFFFFIFFFXX FFFFX
X FF     BFFFXFFFBFFFFFF FFFF  X
XFFF       FXXFFFFFFFFFFF      X
XXXXXXXXXXXXXXXXXXXXXXXXXXXXXXXX