XXXXXXXXXXXXXXXXXXXXXXXXXXXXXXXX
XXXX        X            XXXXXXX
XXXX     H       XXXXXX  XOOXXXX
XXXX 2 X         XXXXXX  X     X
X      X     XXXXXXXXXX       XX
X 1 0  X    XXXXXXX      X    XX
X    X   H  XXXXXXX   X  X  H XX
X H  X3     X     X   X        X
X 4 X                      X   X
X   X                      X   X
XXX X     X      X            XX
XXXXXXX   X   XXXX            XX
XXXXXXX   X   XXXX          K XX
XXXXXXX   X   XXXX      E      X
X               X   X  X   H Y X
XX    XXXXXX    X   X  X       X
XX X  XXXXXX    X   X  X  X  / X
XX X  XXXXXX    X H X     X  XXX
X  X X          X   X     X  XXX
X  X X   XXXXXXXX   X     X    X
X  X X   XXXXXXXX   XXX   X  * X
XXXXXXXXXXXXXXXXXXXXXXXXXXXXXXXX
