XXXXXXXXXXXXXXXXXXXXXXXXXXXXXXXX
XXXXXXX        XXXX X     FFFFFX
XXXXXX   0 1 2 XXXX  F  B   FF X
XXXXX   3 4 FF XXXX    B  B F  X
XFXXXFF B   FF  XXX    F    F  X
X   FX  F FFF    XX      F X  IX
X   XXXX               XXX F   X
X   XXXX   X     Z    XXXX     X
X  X FXF FXF       XXXXXXX    FX
XFF FX    XFXFI  XXXXXXXXX B   X
XFF   FXXF FFFXXXXXXXXXXXX     X
XFFXXXXXXXXX FF XXXXXXXXXX     X
XFXXXXXXXXXXXXF IF XXXXXXFI    X
XB XXXXXXXXXXXFF     F   FI    X
X   XXXXXXXXXF   XXX       F   X
X   XXXXXXXXF  M XXX       FF  X
X    XXXF FFFXX FXXX   P    L  X
X XX XFXX              G  XXX  X
XXFF         XXXFF  B B   XXX BX
XFFF  F      XXX    F     XCX  X
XFFFFF  F    XXX        F      X
XXXXXXXXXXXXXXXXXXXXXXXXXXXXXXXX
