XXXXXXXXXXXXXXXXXXXXXXXXXXXXXXXX
XXXXXXX        XXXX X     FFFFFX
XXXXXX   0 1 2 XXXX  F  B   FF X
XXXXX   3 4 FF XXXX    B  B F  X
XFXXXFF B   FF  XXX    F    F  X
X   FX  F FFF    XX      F X  IX
X   XXXX               XXX F   X
X   XXXX   X          XXXX     X
X  X FXF FXF       XXXXXXX    FX
XFF FX    XFXFI  XXXXXXXXX B   X
XFF   FXXF FFFXXXXXXXXXXXX     X
XFFXXXXXXXXX FF XXXXXXXXXX     X
XFXXXXXXXXXXXXF IF XXXXXXFI    X
XB XXXXXXXXXXXFF     F   FI    X
X   XXXXXXXXXF   XXX       F   X
X   XXXXXXXXF    XXX       FF  X
X    XXXF FFFXXBFXXX           X
X XX XFXX                 CCC  X
XXFF         XXXFF  B B   CCC BX
XFFF  F      XXX    F     CCC  X
XFFFFF  F    XXX        F      X
XXXXXXXXXXXXXXXXXXXXXXXXXXXXXXXX
