XXXXXXXXXXXXXXXXXXXXXXXXXXXXXXXX
X    X                  XXX X  X
X    X                      XXXX
X    X                        FX
X    X             XXX        FX
X   XX             XXX      XXXX
X                         F X  X
X                           XXXX
X  3  1                        X
X   0                      XXXXX
X   2  4                       X
XXXXXXXXXXX      F             X
X            XXXXXXXX     F    X
X                F    M        X
X                F XXX   G  Q  X
X     F            XXX     F   X
X    F   XXX   J       Z    XXXX
X  F               L           X
XF              XXX       F   XX
XXXX            XXX      F     X
XXXX       XXX                 X
XXXXXXXXXXXXXXXXXXXXXXXXXXXXXXXX
