XXXXXXXXXXXXXXXXXXXXXXXXXXXXXXXX
X    D                  UUU D  X
X    D                      DDDX
X    D                        FX
X    D             UUU        FX
X   DD             UUU      DDDX
X                         F D  X
X                           DDDX
X  3  1                        X
X   0                      DDDDX
X   2  4                       X
XDDDDDDDDDD      F             X
X            DDDDDDDD     F    X
X                F             X
X                F UUU         X
X     F            UUU     F   X
X    F   DDD                DDDX
X  F                           X
XF              UUU       F   DX
XDDD            UUU      F     X
XDDD       uuu                 X
XXXXXXXXXXXXXXXXXXXXXXXXXXXXXXXX
